4 9
4 4 5 5 6 4 7 5 8
4 3 3 3 3 3 3 3 4 4
3 3 1 2 2 2 2 3 4 4
3 1 1 1 3 3 3 3 3 3
3 1 1 1 5 1 5 1 6 3
3 3 3 1 1 5 1 5 1 3
4 4 3 3 3 1 1 1 1 3
4 4 4 4 3 3 3 3 3 3 
4 4 4 4 4 4 4 4 4 4
4 4 4 4 4 4 4 4 4 4
4 4 4 4 4 4 4 4 4 4