4 4 4 4 4 4 4 4 4 4
4 4 4 4 4 4 4 4 4 4
4 4 4 4 4 4 4 4 4 4
4 4 4 3 3 3 4 4 4 4
4 4 4 3 2 3 3 4 4 4
4 4 3 3 5 6 3 4 4 4
4 4 3 2 5 1 3 4 4 4
4 4 3 3 3 3 3 4 4 4
4 4 4 4 4 4 4 4 4 4
4 4 4 4 4 4 4 4 4 4