4 4 4 4 4 4 4 4 4 4
4 4 4 4 4 4 4 4 4 4
4 4 4 4 4 4 4 4 4 4
4 4 4 3 3 3 3 4 4 4
4 4 3 3 6 1 3 4 4 4
4 4 3 2 5 5 3 3 4 4
4 4 3 3 1 1 2 3 4 4
4 4 4 3 3 3 3 3 4 4
4 4 4 4 4 4 4 4 4 4
4 4 4 4 4 4 4 4 4 4