4 4 4 4 4 4 4 4 4 4
4 4 4 4 4 4 4 4 4 4
4 4 3 3 3 3 3 4 4 4
4 4 3 1 2 1 3 3 4 4
4 4 3 1 1 1 1 3 4 4
4 4 3 1 2 5 1 3 4 4
4 4 3 3 3 5 1 3 4 4
4 4 4 4 3 1 6 3 4 4
4 4 4 4 3 3 3 3 4 4
4 4 4 4 4 4 4 4 4 4