4 4 4 4 4 4 4 4 4 4
4 4 4 4 4 4 4 4 4 4
4 4 3 3 3 3 3 4 4 4
4 4 3 1 1 1 3 3 4 4
4 4 3 1 1 5 6 3 4 4
4 4 3 3 5 1 2 3 4 4
4 4 4 3 1 1 2 3 4 4
4 4 4 3 3 3 3 3 4 4
4 4 4 4 4 4 4 4 4 4
4 4 4 4 4 4 4 4 4 4