4 4 4 4 4 4 4 4 4 4
4 4 4 4 4 4 4 4 4 4
4 4 4 3 3 3 3 3 4 4
4 4 3 3 6 2 2 3 4 4
4 4 3 1 5 5 3 3 4 4
4 4 3 1 1 1 1 3 4 4
4 4 3 3 1 1 1 3 4 4
4 4 4 3 3 3 3 3 4 4
4 4 4 4 4 4 4 4 4 4
4 4 4 4 4 4 4 4 4 4